WWWWWWWWWWWWWWWWWWWWW
W    W    W         W
W    W    W         W
W    W  T W        PW
W  S W    WE        W
W    W              W
W    W              W
W        W   W      W
WM       W   W      W
WWWWWW   W   W      W
W   G    W  GW      W
W        W  MW     XW
WWWWWWWWWWWWWWWWWWWWW