WWWWWWWWWWWWWWWWWWWWWWWWWWWWWWWWWWWWWW
WGT  W    W                      S   W
W    W    W                          W
W    W  T W                         PW
W    W    WE                         W
W    W                               W
W    W                               W
W        W   W                       W
WM       W   W                       W
WWWWWWWWWW   W                       W
W   G    W  GW                       W
W        W  MWWWWWWWWWWWWWWWWWWWWWWWWW
W    W                               W
W    W                               W
W    W                         G     W
W    W                         G     W
W    W                               W
W    W                               W
W    WWWWWWWWWWWWWWWWWWWWWWWWWWWWWWWWW
WE                                  XW
WWWWWWWWWWWWWWWWWWWWWWWWWWWWWWWWWWWWWW
