WWWWWWWWWWWWWWWWWWWWWWWWWWWWWWWWWWWWWW
W    W GGGW                   WX M  TW
W    W    W               W   W      W
W    W  T W               W   W     PW
W    W    WE              W   W      W
W    W    W               W   W      W
W    W                    W   W      W
W        W   W            WMPTW      W
WM       W   W            WWWWW      W
WWWWWWWWWW   W                       W
W   G    W  GW  T         M          W
W        W  MWWWWWWWWWWWWWWWWWWWWWWWWW
W                              G    MW
W                                    W
W                                    W
W                                    W
W                                    W
W    S                               W
W                                    W
W                              G     W
WWWWWWWWWWWWWWWWWWWWWWWWWWWWWWWWWWWWWW
